// Level 01:

{
	"width": 10,
	"height": 14,
	"grid": [
		0, 0, 1, 1, 2, 2, 3, 3, 4, 4,
		0, 0, 1, 1, 2, 2, 3, 3, 4, 8,
		5, 5, 6, 6, 7, 7, 0, 0, 1, 1,
		5, 5, 6, 6, 7, 7, 0, 0, 1, 8,
		8, 8, 8, 8, 8, 8, 8, 8, 8, 8,
		8, 8, 8, 8, 8, 8, 8, 8, 8, 8,
		8, 8, 8, 8, 8, 8, 8, 8, 8, 8,
		8, 8, 8, 8, 8, 8, 8, 8, 8, 8,
		8, 8, 8, 8, 8, 8, 8, 8, 8, 8,
		8, 8, 8, 8, 8, 8, 8, 8, 8, 8,
		8, 8, 8, 8, 8, 8, 8, 8, 8, 8,
		8, 8, 8, 8, 8, 8, 8, 8, 8, 8,
		8, 8, 8, 8, 8, 8, 8, 8, 8, 8,
		8, 8, 8, 8, 8, 8, 8, 8, 8, 8
	]
}