// Level 03:

{
	"width": 10,
	"height": 14,
	"grid": [
		2, 8, 8, 8, 8, 8, 8, 8, 8, 2,
		0, 1, 2, 3, 4, 5, 6, 7, 0, 8,
		7, 8, 8, 8, 8, 8, 8, 8, 8, 7,
		1, 7, 6, 2, 1, 7, 6, 0, 1, 8,
		8, 8, 8, 8, 1, 8, 8, 8, 8, 8,
		8, 8, 8, 8, 2, 8, 8, 8, 8, 8,
		8, 8, 8, 8, 1, 8, 8, 8, 8, 8,
		8, 8, 8, 8, 8, 8, 8, 8, 8, 8,
		8, 8, 8, 8, 8, 8, 8, 8, 8, 8,
		8, 8, 8, 8, 8, 8, 8, 8, 8, 8,
		8, 8, 8, 8, 8, 8, 8, 8, 8, 8,
		8, 8, 8, 8, 8, 8, 8, 8, 8, 8,
		8, 8, 8, 8, 8, 8, 8, 8, 8, 8,
		8, 8, 8, 8, 8, 8, 8, 8, 8, 8
	]
}