// Level 05:

{
	"width": 10,
	"height": 14,
	"grid": [
		8, 0, 8, 3, 8, 4, 8, 5, 8, 6,
		4, 8, 2, 8, 5, 8, 2, 8, 1, 8,
		3, 8, 4, 8, 2, 8, 2, 8, 7, 8,
		8, 1, 8, 5, 8, 7, 8, 7, 8, 8,
		8, 7, 8, 1, 8, 3, 8, 3, 8, 8,
		8, 8, 6, 8, 5, 8, 2, 8, 8, 8,
		8, 8, 8, 8, 6, 8, 6, 8, 8, 8,
		8, 8, 8, 8, 8, 7, 8, 8, 8, 8,
		8, 8, 8, 8, 8, 8, 8, 8, 8, 8,
		8, 8, 8, 8, 8, 8, 8, 8, 8, 8,
		8, 8, 8, 8, 8, 8, 8, 8, 8, 8,
		8, 8, 8, 8, 8, 8, 8, 8, 8, 8,
		8, 8, 8, 8, 8, 8, 8, 8, 8, 8,
		8, 8, 8, 8, 8, 8, 8, 8, 8, 8
	]
}