// Level 06:

{
	"width": 10,
	"height": 14,
	"grid": [
		6, 7, 2, 1, 2, 3, 1, 5, 0, 7,
		5, 8, 1, 8, 1, 8, 3, 8, 7, 8,
		8, 3, 3, 0, 6, 6, 1, 5, 1, 8,
		8, 7, 8, 0, 8, 5, 8, 3, 8, 8,
		8, 7, 6, 3, 7, 3, 5, 1, 0, 8,
		0, 8, 6, 8, 6, 8, 1, 8, 3, 8,
		1, 0, 2, 2, 3, 7, 5, 6, 6, 0,
		8, 8, 8, 8, 8, 8, 8, 8, 8, 8,
		8, 8, 8, 8, 8, 8, 8, 8, 8, 8,
		8, 8, 8, 8, 8, 8, 8, 8, 8, 8,
		8, 8, 8, 8, 8, 8, 8, 8, 8, 8,
		8, 8, 8, 8, 8, 8, 8, 8, 8, 8,
		8, 8, 8, 8, 8, 8, 8, 8, 8, 8,
		8, 8, 8, 8, 8, 8, 8, 8, 8, 8
	]
}