// Level 07:

{
	"width": 10,
	"height": 14,
	"grid": [
		8, 8, 8, 8, 5, 7, 8, 8, 8, 8,
		8, 8, 8, 6, 2, 7, 8, 8, 8, 8,
		8, 8, 8, 8, 1, 7, 8, 8, 8, 8,
		8, 8, 7, 4, 8, 5, 5, 8, 8, 8,
		8, 8, 6, 6, 7, 6, 4, 5, 8, 8,
		8, 8, 4, 5, 8, 5, 1, 8, 8, 8,
		8, 8, 8, 8, 0, 6, 8, 8, 8, 8,
		8, 8, 8, 1, 2, 5, 8, 8, 8, 8,
		8, 8, 8, 8, 1, 0, 8, 8, 8, 8,
		8, 8, 8, 8, 8, 8, 8, 8, 8, 8,
		8, 8, 8, 8, 8, 8, 8, 8, 8, 8,
		8, 8, 8, 8, 8, 8, 8, 8, 8, 8,
		8, 8, 8, 8, 8, 8, 8, 8, 8, 8,
		8, 8, 8, 8, 8, 8, 8, 8, 8, 8
	]
}