// Level 08:

{
	"width": 10,
	"height": 14,
	"grid": [
		5, 3, 2, 6, 0, 1, 3, 7, 1, 0,
		0, 7, 7, 6, 3, 0, 5, 7, 3, 1,
		3, 5, 3, 7, 6, 6, 4, 2, 5, 2,
		4, 7, 6, 4, 0, 5, 1, 0, 6, 4,
		5, 0, 3, 4, 5, 0, 7, 0, 1, 7,
		8, 8, 8, 8, 8, 8, 8, 8, 8, 8,
		8, 8, 8, 8, 8, 8, 8, 8, 8, 8,
		8, 8, 8, 8, 8, 8, 8, 8, 8, 8,
		8, 8, 8, 8, 8, 8, 8, 8, 8, 8,
		8, 8, 8, 8, 8, 8, 8, 8, 8, 8,
		8, 8, 8, 8, 8, 8, 8, 8, 8, 8,
		8, 8, 8, 8, 8, 8, 8, 8, 8, 8,
		8, 8, 8, 8, 8, 8, 8, 8, 8, 8,
		8, 8, 8, 8, 8, 8, 8, 8, 8, 8
	]
}