// Level 09:

{
	"width": 10,
	"height": 14,
	"grid": [
		4, 4, 4, 4, 4, 4, 4, 4, 4, 4,
		4, 8, 8, 8, 8, 8, 8, 8, 4, 8,
		4, 8, 8, 8, 8, 8, 8, 8, 8, 4,
		4, 8, 8, 8, 3, 7, 0, 1, 5, 8,
		4, 8, 8, 8, 8, 8, 1, 7, 5, 8,
		1, 0, 8, 8, 8, 8, 8, 2, 6, 8,
		2, 1, 1, 7, 8, 8, 8, 8, 8, 8,
		6, 7, 1, 7, 2, 8, 8, 8, 8, 8,
		8, 8, 8, 8, 8, 8, 8, 8, 8, 8,
		8, 8, 8, 8, 8, 8, 8, 8, 8, 8,
		8, 8, 8, 8, 8, 8, 8, 8, 8, 8,
		8, 8, 8, 8, 8, 8, 8, 8, 8, 8,
		8, 8, 8, 8, 8, 8, 8, 8, 8, 8,
		8, 8, 8, 8, 8, 8, 8, 8, 8, 8
	]
}