// Level 1:

{
	"width": 10,
	"height": 15,
	"grid": [
		61, 61, 71, 71, 51, 51, 41, 41, 31, 31,
		61, 61, 71, 71, 51, 51, 41, 41, 31, 0,
		21, 21, 11, 11, 1, 1, 61, 61, 71, 71,
		21, 11, 11, 1, 1, 61, 61, 71, 71, 0,
		0, 0, 0, 0, 0, 0, 0, 0, 0, 0,
		0, 0, 0, 0, 0, 0, 0, 0, 0, 0,
		0, 0, 0, 0, 0, 0, 0, 0, 0, 0,
		0, 0, 0, 0, 0, 0, 0, 0, 0, 0,
		0, 0, 0, 0, 0, 0, 0, 0, 0, 0,
		0, 0, 0, 0, 0, 0, 0, 0, 0, 0,
		0, 0, 0, 0, 0, 0, 0, 0, 0, 0,
		0, 0, 0, 0, 0, 0, 0, 0, 0, 0,
		0, 0, 0, 0, 0, 0, 0, 0, 0, 0,
		0, 0, 0, 0, 0, 0, 0, 0, 0, 0,
		0, 0, 0, 0, 0, 0, 0, 0, 0, 0
	]
}