// Level 10:

{
	"width": 10,
	"height": 14,
	"grid": [
		0, 8, 8, 8, 8, 8, 8, 8, 8, 6,
		6, 1, 7, 2, 4, 5, 3, 1, 0, 8,
		0, 8, 8, 8, 8, 8, 8, 8, 8, 6,
		6, 1, 7, 2, 4, 5, 3, 1, 0, 8,
		0, 8, 8, 8, 8, 8, 8, 8, 8, 6,
		6, 1, 7, 2, 4, 5, 3, 1, 0, 8,
		8, 8, 8, 8, 8, 8, 8, 8, 8, 8,
		8, 8, 8, 8, 8, 8, 8, 8, 8, 8,
		8, 8, 8, 8, 8, 8, 8, 8, 8, 8,
		8, 8, 8, 8, 8, 8, 8, 8, 8, 8,
		8, 8, 8, 8, 8, 8, 8, 8, 8, 8,
		8, 8, 8, 8, 8, 8, 8, 8, 8, 8,
		8, 8, 8, 8, 8, 8, 8, 8, 8, 8,
		8, 8, 8, 8, 8, 8, 8, 8, 8, 8
	]
}