// Level 11:

{
	"width": 10,
	"height": 14,
	"grid": [
		8, 8, 8, 8, 2, 2, 8, 8, 8, 8,
		8, 8, 8, 1, 0, 1, 8, 8, 8, 8,
		8, 8, 8, 7, 5, 4, 4, 8, 8, 8,
		8, 8, 1, 3, 7, 4, 5, 8, 8, 8,
		8, 8, 8, 4, 1, 6, 3, 8, 8, 8,
		8, 8, 8, 6, 6, 1, 8, 8, 8, 8,
		8, 8, 8, 8, 4, 0, 8, 8, 8, 8,
		8, 8, 8, 8, 7, 8, 8, 8, 8, 8,
		8, 8, 8, 8, 8, 8, 8, 8, 8, 8,
		8, 8, 8, 8, 8, 8, 8, 8, 8, 8,
		8, 8, 8, 8, 8, 8, 8, 8, 8, 8,
		8, 8, 8, 8, 8, 8, 8, 8, 8, 8,
		8, 8, 8, 8, 8, 8, 8, 8, 8, 8,
		8, 8, 8, 8, 8, 8, 8, 8, 8, 8
	]
}