// Level 12:

{
	"width": 10,
	"height": 14,
	"grid": [
		8, 8, 8, 8, 6, 2, 8, 8, 8, 8,
		8, 8, 8, 2, 1, 6, 8, 8, 8, 8,
		8, 8, 8, 1, 6, 2, 1, 8, 8, 8,
		8, 8, 6, 2, 1, 6, 2, 8, 8, 8,
		8, 8, 2, 1, 6, 2, 1, 6, 8, 8,
		8, 1, 6, 2, 1, 6, 2, 1, 8, 8,
		8, 6, 2, 1, 6, 2, 1, 6, 2, 8,
		2, 1, 6, 2, 1, 6, 2, 1, 6, 8,
		1, 6, 2, 1, 6, 2, 1, 6, 2, 1,
		8, 8, 8, 8, 8, 8, 8, 8, 8, 8,
		8, 8, 8, 8, 8, 8, 8, 8, 8, 8,
		8, 8, 8, 8, 8, 8, 8, 8, 8, 8,
		8, 8, 8, 8, 8, 8, 8, 8, 8, 8,
		8, 8, 8, 8, 8, 8, 8, 8, 8, 8
	]
}