// Level 13:

{
	"width": 10,
	"height": 14,
	"grid": [
		1, 1, 4, 7, 6, 6, 7, 4, 1, 1,
		3, 1, 4, 7, 6, 7, 4, 1, 5, 8,
		2, 2, 1, 4, 7, 7, 4, 1, 4, 4,
		0, 3, 1, 4, 7, 4, 1, 2, 2, 8,
		5, 0, 3, 1, 4, 4, 1, 4, 3, 0,
		4, 5, 7, 1, 4, 1, 4, 3, 0, 8,
		2, 5, 2, 6, 1, 1, 7, 5, 2, 0,
		2, 0, 3, 5, 1, 4, 5, 2, 0, 8,
		1, 7, 6, 3, 2, 5, 2, 7, 2, 5,
		8, 8, 8, 8, 8, 8, 8, 8, 8, 8,
		8, 8, 8, 8, 8, 8, 8, 8, 8, 8,
		8, 8, 8, 8, 8, 8, 8, 8, 8, 8, 
		8, 8, 8, 8, 8, 8, 8, 8, 8, 8,
		8, 8, 8, 8, 8, 8, 8, 8, 8, 8
	]
}