// Level 14:

{
	"width": 10,
	"height": 14,
	"grid": [
		7, 8, 0, 8, 8, 8, 6, 8, 8, 7,
		1, 8, 4, 8, 8, 6, 7, 6, 5, 8,
		8, 7, 8, 6, 2, 4, 1, 8, 4, 8,
		8, 0, 8, 8, 8, 8, 8, 6, 8, 8,
		8, 5, 2, 7, 1, 6, 2, 4, 8, 1,
		0, 8, 8, 8, 8, 8, 8, 8, 2, 8,
		8, 5, 0, 5, 7, 6, 6, 0, 7, 8,
		8, 8, 8, 8, 8, 8, 8, 8, 8, 8,
		8, 8, 8, 8, 8, 8, 8, 8, 8, 8,
		8, 8, 8, 8, 8, 8, 8, 8, 8, 8,
		8, 8, 8, 8, 8, 8, 8, 8, 8, 8,
		8, 8, 8, 8, 8, 8, 8, 8, 8, 8,
		8, 8, 8, 8, 8, 8, 8, 8, 8, 8,
		8, 8, 8, 8, 8, 8, 8, 8, 8, 8
	]
}